##########
#_######_#
#_######_#
#_######_#
#_######_#
#_######_#
#_######_#
#________#
##########
